*************************************
*     *     *       *     *       * *
* *** * *** * ***** * *** * ***** * *
* *   * *   *     * *   * *     * * *
* * ***** ******* ***** ******* * * *
* *     *     *       *     *   * * *
* ***** * *** * ***** * *** * *** * *
*     * * *   * *     * *   *     * *
***** * * * ***** ***** ********* * *
*     * * *     *     *       *   * *
* ***** * ***** * ***** ***** * *** *
* *     *     * *     *     * *     *
* * ********* * ***** * *** * *******
* *         * *     * * *   *       *
* ********* * ***** * * * ******* * *
*L          *       *   *         * *
*************************************