*************************************
* * *       * * * * * * * * * * * * *
* * * ***** * * * * * * * * * * * * *
* * * *   * * * * * * * * * * * * * *
* * *** * * * * * * * * * * * * * * *
* *     * * * * * * * * * * * * * * *
* ******* * * * * * * * * * * * * * *
*         * * * * * * * * * * * * * *
********* * * * * * * * * * * * * * *
* *       * * * * * * * * * * * * * *
* * ******* * * * * * * * * * * * * *
* * *   *   * * * * * * * * * * * * *
* * * * * * * * * * * * * * * * * * *
* * * * * * * * * * * * * * * * * * *
* * * * * * * * * * * * * * * * * * *
*L* * * * * * * * * * * * * * * * * *
*************************************