*************************************
* *   *       * *     *   *         *
* * * * ***** * * *** * * * ***** * *
*   * * *     * * * *   * * *   * * *
***** * * ******* * * ***** * * * * *
*   *   * *       * * *     * * * * *
* * ***** * ***** * * * ***** * * * *
* * *       * *   *   *     *   * * *
* * * ***** * * ******* ********  * *
* * * *   * * * *     * *   * *   * *
* * * * * * * * ******* * * * ***** *
*   *   * *   *     * L * * *       *
* ***** * ********* * ***** *********
* *   * *     *     * *   *         *
* * *** ***** ******* * * ***********
* *           *         *           *
*************************************